XXXXXXXXXXXXXXXXXXXXXXXXXXX
X___O________X________O___X
X_XXXX_XXXXX_X_XXXXX_XXXX_X
X_XXXX_XXXXX_X_XXXXX_XXXX_X
X_XXXX_XXXXX_X_XXXXX_XXXX_X
XP___________O____________X
X_XXXX_XX_XXXXXXX_XX_XXXX_X
X_XXXX_XX_XXXXXXX_XX_XXXX_X
X______XX_________XX______X
XXXXXX_XX_XXX_XXX_XX_XXXXXX
=====X_XX_XXXOXXX_XX_X=====
=====X_XX_________XX_X=====
=====X_XX__XXYXX__XX_X=====
XXXXXX_XX__X===X__XX_XXXXXX
X=====__O__X=B=X__3__=====X
XXXXXX_XX__X===X__XX_XXXXXX
=====X_XX__XXXXX__XX_X=====
=====X_XX_________XX_X=====
=====X_XX_XXXFXXX_XX_X=====
XXXXXX_XX_XXX_XXX_XX_XXXXXX
X__O___XX__1______XX______X
X_XXXX_XX_XXXXXXX_XX_XXXX_X
X_XXXX_XX_XXXXXXX_XX_XXXX_X
X_____2______O_2___O______X
X_XXXX_XXXXX_X_XXXXX_XXXX_X
X_XXXX_XXXXX_X_XXXXX_XXXX_X
X_XXXX_XXXXX_X_XXXXX_XXXX_X
X___O________X____1___O___X
XXXXXXXXXXXXXXXXXXXXXXXXXXX